888888888888888888888888888
8dddcddd889dddddddddcdddda8
8a00000988900000000000000a8
8a00000dddd00450045004500a8
8a00000333300000000000000a8
8a00000333300450045004500a8
8a000009dda00000000000000a8
8a00000a889000000000add3da8
8da19dcdddd000000000a893da8
89222222333000000000a893da8
89244422ddd000000000a893da8
89222222a89dd00000dda891da8
89255522a8889d111da88893da8
89222222a89ddd111dddddd3da8
89222222a8900000000000000a8
89da116669d00000000000000a8
8922222222200000000000000a8
8922222222200000000000000a8
89bbbbbbbbbbbbbbbbbbbbbbba8
888888888888888888888888888