888888888888888888888888888
877777778877777777777777778
870000078870000000000000078
870000077770045004500450078
870000033330000000000000078
870000033330045004500450078
870000077770000000000000078
870000078870000000007773778
877177777770000000007873778
872222223330000000007873778
872444227770000000007873778
872222227877700000777871778
872555227888771117788873778
872222227877771117777773778
872222227870000000000000078
877711666770000000000000078
872222222220000000000000078
872222222220000000000000078
877777777777777777777777778
888888888888888888888888888