0000000000000000000000000
0000000000000000000000000
0000000000000000000000000
0000000000000000000000000
7770777777777777777777777
7000007777000000000000007
7000007777004500450045007
7000003333000000000000007
7000003333004500450045007
7000007777000000000000007
7000007777000000000000007
7777777777000000000000007
7222222777000000000000007
7244422777000000000000007
7222222777
7255522777
7222222777
7222222777

7777777777000000000000007
7777777777000000000000007
7777777777000000000000007
7777777777000000000000007