888888888888888888888888888
811171118811111111117111118
810000018810000000000000018
810000011110045004500450018
810000033330000000000000018
810000033330045004500450018
810000011110000000000000018
810000018810000000001113118
811311711110000000001813118
812222223330000000001813118
812444221110000000001813118
812222221811100000111813118
812555221888113331188813118
812222221811113331111113118
812222221810000000000000018
811133666110000000000000018
812222222220000000000000018
812222222220000000000000018
811111111111111111111111118
888888888888888888888888888